1 1 1 1 1 1 1 1 1 1 1 1 1 1 1 1 1 1 1 1
1 5 2 2 2 2 2 2 2 2 2 2 2 2 2 2 2 2 3 1
1 5 1 1 1 1 1 1 1 1 1 1 1 1 1 1 1 1 3 1
1 5 1 1 1 1 1 1 1 1 1 1 1 1 1 1 1 1 3 1
1 5 1 1 1 1 1 1 1 1 1 1 1 1 1 1 1 1 3 1
1 5 1 1 1 1 1 1 1 1 1 1 1 1 1 1 1 1 3 1
1 5 1 1 1 1 1 1 1 1 1 1 1 1 1 1 1 1 3 1
1 5 1 1 1 1 1 1 1 1 1 1 1 1 1 1 1 1 3 1
1 5 1 1 1 1 1 1 1 1 1 1 1 1 1 1 1 1 3 1
1 5 1 1 1 1 1 1 1 1 1 1 1 1 1 1 1 1 3 1
1 8 4 4 4 4 4 4 6 1 1 9 4 4 4 4 4 4 7 1
1 1 1 1 1 1 1 1 5 1 1 3 1 1 1 1 1 1 1 1