20
12
0 0 0 0 0 0 0 0 4 0 0 2 0 0 0 0 0 0 0 0
0 4 1 1 1 1 1 1 1 0 0 1 1 1 1 1 1 1 2 0
0 4 0 0 0 0 0 0 0 0 0 0 0 0 0 0 0 0 2 0
0 4 0 0 0 0 0 0 0 0 0 0 0 0 0 0 0 0 2 0
0 4 0 0 0 0 0 0 0 0 0 0 0 0 0 0 0 0 2 0
0 4 0 0 0 0 0 0 0 0 0 0 0 0 0 0 0 0 2 0
0 4 0 0 0 0 0 0 0 0 0 0 0 0 0 0 0 0 2 0
0 4 0 0 0 0 0 0 0 0 0 0 0 0 0 0 0 0 2 0
0 4 0 0 0 0 0 0 0 0 0 0 0 0 0 0 0 0 2 0
0 4 0 0 0 0 0 0 0 0 0 0 0 0 0 0 0 0 2 0
0 7 3 3 3 3 3 3 5 0 0 8 3 3 3 3 3 3 6 0
0 0 0 0 0 0 0 0 4 0 0 2 0 0 0 0 0 0 0 0